#########################################
#.................#.#...................#
#...................#.......#.####.#.#..#
#...#.............#.#.......#.#....#.#..#
#.................#.#########.#....#.#..#
#.................#...........#....#.#..#
#######..###########################.#..#
#......M....................#........#..#
###########################.#.#########.#
#.....#.....#.....#.......#.#.#.......#.#
#.....#.....#.....#.......#.#.#.......#.#
#.....#.....#.....#.......#.#.#.......#.#
###.#####.#####.######.####.#.#.#######.#
#...........................#...........#
###.#####.#####.######.####.######.######
#.....#.....#.....#.......#.#...........#
#.....#.....#.....#.......#.#...........#
#.....#.....#.....#.......#.#...........#
###########################........@....#
#...#........#......#.......#...........#
#.........#......#........#.#...........#
#########################################