###################
#.................#
#.###############.#
#.......##........#
#######.##.########
##......##.##.....#
##.#######....#####
##.##########.#####
##............#####
###################