#############################
#.................#.........#
#.###############...#.......#
#.......##........#.#.......#
#######.##.########.#########
##......##.##.....#..........
##......##....###############
##......#####...............#
##............#####.........#
################............#
#................############
#.........##########........#
#.........##########........#
#...........................#
#############################