#########################################
#.................#.#.......d...........#
#.................d.#.......#.####d#.#..#
#...#...@.........#.#.......#.#....#.#..#
#.................#.#########.#....#.#..#
#.................#...........#....#.#..#
#######dd###########################.#..#
#...........................#........#..#
###########################.#.#########.#
#.....#.....#.....#.......#.#.#.......#.#
#.....#.....#.....#.......#.#.#.......#.#
#.....#.....#.....#.......#.#.#.......#.#
###d#####d#####d######d####.#.#d#######.#
#...........................#...........#
###d#####d#####d######d####.######d######
#.....#.....#.....#.......#.#...........#
#.....#.....#.....#.......#.#...........#
#.....#.....#.....#.......#.#......M....#
###########################.d...........#
#...#........#......#.......#...........#
#.........#......#..........#...........#
#########################################