#########################################
#.................#.#................#..#
#.###############...#.......#.....#..#..#
#.......##........#.#.......#.....#..#..#
#######.##.########.#########.....#..#..#
##......##.##.....#...............#..#..#
##......##.##.#####################..#..#
##......#####...............#........#..#
##............#####.........#.#########.#
################............#.#.......#.#
#................############.#.......#.#
#.........##########........#.#.......#.#
#.........##########........#.#.#######.#
#...........................#...........#
#########################################
#
#
#
#
#
#
#########################################