#########################################
#.................#.#...................#
#...................#.......#.####.#.#..#
#...#....@........#.#.......#.#....#.#..#
#.................#.#########.#....#.#..#
#.................#...........#....#.#..#
#######..###########################.#..#
#...........................#........#..#
###########################.#.#########.#
#.....#.....#.....#.......#.#.#.......#.#
#.....#.....#.....#.......#.#.#.......#.#
#.....#.....#.....#.......#.#.#.......#.#
###.#####.#####.######.####.#.#.#######.#
#...........................#...........#
###.#####.#####.######.####.######.######
#.....#.....#.....#.......#.#...........#
#.....#.....#.....#.......#.#...........#
#.....#.....#.....#.......#.#...........#
###########################........M....#
#...#........#......#.......#...........#
#.........#......#........#.#...........#
#########################################